{
  "levels": [
    {
      "name": "Test Level",
      "layout": [
        [5, 2, 2, 2, 2, 2, 2, 2, 2, 2, 2, 2, 2, 2, 2, 6],
        [1, 0, 0, 0, 0, 0, 0, 0, 0, 0, 0, 0, 0, 0, 0, 3],
        [1, 0, 0, 0, 0, 0, 0, 0, 0, 0, 0, 0, 0, 0, 0, 3],
        [1, 0, 0, 0, 0, 9, 9, 9, 9, 9, 9, 0, 0, 0, 0, 3],
        [1, 0, 0, 0, 0, 9, 9, 9, 9, 9, 9, 0, 0, 0, 0, 3],
        [1, 0, 0, 0, 0, 9, 9, 9, 9, 9, 9, 0, 0, 0, 0, 3],
        [1, 0, 0, 0, 0, 0, 0, 0, 0, 0, 0, 0, 0, 0, 0, 3],
        [1, 0, 0, 0, 0, 0, 0, 0, 0, 0, 0, 0, 0, 0, 0, 3],
        [8, 4, 4, 4, 4, 4, 4, 4, 4, 4, 4, 4, 4, 4, 4, 7]
      ]
    }
  ]
}